##################################################
#@####  ######  #                   ########     #
# ###              ########### # #    ###   #### #
#       ############   ####### # #       ## ###  #
#########    ########   ## ##  # #  ####   ##### #
######  ## #######    #### ###   # ##  ####### ###
##### ####   #######   ###   ### # ### ######  ###
####  ###### ###   #### ##########  ## #####  ####                                                #
####  ####   ####  ###    ##### ##  ##  #### #####
##### #####     ##  ###  ####   ## # # ####   ####
#                                                #
#                                                #
#                                                #
#                                                #
#                                                #
#                                                #
#                                                #
#                                                #
#                                                #
#                                                #
#                                                #
#                                                #
#                                                #
#                                                #
#                                                #
#                                                #
#                                                #
#                                                #
#                                                #
#                                                #
#                                                #
#                                                #
#                                                #
#                                                #
#                                                #
#                                                #
#                                                #
#                                                #
#                                                #
#                                                #
#                                                #
#                                                #
#                                                #
#                                                #
#                                                #
#                                                #
#                                                #
#                                                #
##################################################
